g g g g g g g g g g g g g g g g g g g g g g g g g g g g g g g g g g g g g g g g g g g g g g g
g g g g g g g g g g g g g g g g g g g g g g g g g g g g g g g g g g g g g g g g g g g g g g g
g g g g g g g g g g g g g g g g g g g g g g g g g g g g g g g g g g g g g g g g g g g g g g g
g g g g g g g g g g g g g g g g g g g g g g g g g g g g g g g g g g g g g g g g g g g g g g g
g g g g g g g g g g g g g g g g g g g g g g g g g g g g g g g g g g g g g g g g g g g g g g g
g g g g g g g g g g g g g g g g g g g g g g g g g g g g g g g g g g g g g g g g g g g g g g g
g g g g g g g g g g g g g g g g g g g g g g g g g g g g g g g g g g g g g g g g g g g g g g g
g g g g g g g g g g g g g g g g g g g g g g g g g g g g g g g g g g g g g g g g g g g g g g g
g g g g g g g g g g g g g g g g g g g g g g g g g g g g g g g g g g g g g g g g g g g g g g g
g g g g g g g g g g g g g g g g g g g g g g g g g g g g g g g g g g g g g g g g g g g g g g g
g g g g g g g g g g g g 0 0 0 0 2 2 0 0 0 0 g g g 0 0 0 0 2 2 0 0 0 0 g g g g g g g g g g g g
g g g g g g g g g g g g 0 1 1 1 1 1 1 1 1 0 g g g 0 1 1 1 1 1 1 1 1 0 g g g g g g g g g g g g
g g g g g g g g g g g g 0 1 1 1 1 1 1 1 1 0 g g g 0 1 1 1 1 1 1 1 1 0 g g g g g g g g g g g g
g g g g g g g g g g g g 0 1 1 1 1 1 1 1 1 0 0 0 0 0 1 1 1 1 1 1 1 1 0 g g g g g g g g g g g g
g g g g g g g g g g g g 2 1 1 1 1 1 1 1 1 1 1 1 1 1 1 1 1 1 1 1 1 1 2 g g g g g g g g g g g g
g g g g g g g g g g g g 2 1 1 1 1 1 1 1 1 1 1 1 1 1 1 1 1 1 1 1 1 1 2 g g g g g g g g g g g g
g g g g g g g g g g g g 0 1 1 1 1 1 1 1 1 0 0 0 0 0 0 0 0 1 1 1 1 1 0 g g g g g g g g g g g g
g g g g g g g g g g g g 0 1 1 1 1 1 1 1 1 0 1 1 1 1 1 1 0 1 1 1 1 1 0 g g g g g g g g g g g g
g g g g g g g g g g g g 0 1 1 1 1 1 1 1 1 0 1 1 1 1 1 1 0 1 1 1 1 1 0 g g g g g g g g g g g g
g g g g g g g g g g g g 0 0 0 0 2 2 0 0 0 0 1 1 1 1 1 1 0 1 1 0 0 0 0 g g g g g g g g g g g g
g g g g g g g g g g g g 0 1 1 1 1 1 1 1 1 0 1 1 1 1 1 1 0 1 1 0 g g g g g g g g g g g g g g g
g g g g g g g g g g g g 0 1 1 1 1 1 1 1 1 0 1 1 1 1 1 1 0 1 1 0 g g g g g g g g g g g g g g g
g g g g g g g g g g g g 0 1 1 1 1 1 1 1 1 0 1 1 1 1 1 1 0 1 1 0 g g g g g g g g g g g g g g g
g g g g g g g g g g g g 0 1 1 1 1 1 1 1 1 0 0 1 1 0 0 0 0 1 1 0 0 0 0 g g g g g g g g g g g g
g g g g g g g g g g g g 0 1 1 1 1 1 1 1 1 1 1 1 1 0 1 1 1 1 1 1 1 1 0 g g g g g g g g g g g g
g g g g g g g g g g g g 0 1 1 1 1 1 1 1 1 1 1 1 1 0 1 1 1 1 1 1 1 1 0 g g g g g g g g g g g g
g g g g g g g g g g g g 0 1 1 1 1 1 1 1 1 1 1 1 1 0 1 1 1 1 1 1 1 1 0 g g g g g g g g g g g g
g g g g g g g g g g g g 2 1 1 1 1 1 1 1 1 1 1 1 1 1 1 1 1 1 1 1 1 1 2 g g g g g g g g g g g g
g g g g g g g g g g g g 2 1 1 1 1 1 1 1 1 1 1 1 1 1 1 1 1 1 1 1 1 1 2 g g g g g g g g g g g g
g g g g g g g g g g g g 0 1 1 1 1 1 1 1 1 1 1 1 1 0 1 1 1 1 1 1 1 1 0 g g g g g g g g g g g g
g g g g g g g g g g g g 0 1 1 1 1 1 1 1 1 1 1 1 1 0 1 1 1 1 1 1 1 1 0 g g g g g g g g g g g g
g g g g g g g g g g g g 0 1 1 1 1 1 1 1 1 1 1 1 1 0 1 1 1 1 1 1 1 1 0 g g g g g g g g g g g g
g g g g g g g g g g g g 0 0 0 0 2 2 0 0 0 0 0 2 2 0 0 0 0 2 2 0 0 0 0 g g g g g g g g g g g g
g g g g g g g g g g g g g g g g g g g g g g g g g g g g g g g g g g g g g g g g g g g g g g g
g g g g g g g g g g g g g g g g g g g g g g g g g g g g g g g g g g g g g g g g g g g g g g g
g g g g g g g g g g g g g g g g g g g g g g g g g g g g g g g g g g g g g g g g g g g g g g g
g g g g g g g g g g g g g g g g g g g g g g g g g g g g g g g g g g g g g g g g g g g g g g g
g g g g g g g g g g g g g g g g g g g g g g g g g g g g g g g g g g g g g g g g g g g g g g g
g g g g g g g g g g g g g g g g g g g g g g g g g g g g g g g g g g g g g g g g g g g g g g g
g g g g g g g g g g g g g g g g g g g g g g g g g g g g g g g g g g g g g g g g g g g g g g g
g g g g g g g g g g g g g g g g g g g g g g g g g g g g g g g g g g g g g g g g g g g g g g g
g g g g g g g g g g g g g g g g g g g g g g g g g g g g g g g g g g g g g g g g g g g g g g g
g g g g g g g g g g g g g g g g g g g g g g g g g g g g g g g g g g g g g g g g g g g g g g g